33333333333333333333333333333333333333333
31202120212021202122222222222222222222223
30303030303030303030303030303030303030303
31010101010101010110101010101010101010103
30303030323032303032303230323032303230323
31010121001010122101010222220101010222013
30303030303230303032323232323232323232323
31010101010101010101010102010102010102013
32323230303230303032323232323232323232323
31010101010101010101010101020202020221213
33333333333333333333333333333333333333333